0000000000000000000000000000
0000000000000000000000000000
0000000000000000000000000000
0000000000000000000000000000
1111000000000000000000001111
1111111111111111111111111111
1111111111111111111111111111